#########################
#.......................#
###...#.###.#.###.#...###
 .....#.#...#...#.#..... 
###...#.#.#####.#.#...###
#.....#           #.....#
#.###.. ###   ### ..###.#
#..o##. #       # .##o..#
#.###.. ######### ..###.#
#.....#           #.....#
###...#.#.#####.#.#...###
 .....#.#...#...#.#..... 
###...#.###.#.###.#...###
#.......................#
#########################
