#########################
#...........#...........#
#.#####.#.#####.#.#####.#
#.....#.#..o#...#.#.....#
#.###...## ### ##...###.#
#...#.#           #.#...#
###.#.# ###   ### #.#.###
 .....# #       # #..... 
###.#.# ######### #.#.###
#...#.#           #.#...#
#.###...## ### ##...###.#
#.....#.#...#o..#.#.....#
#.#####.#.#####.#.#####.#
#...........#...........#
#########################
