############################
#........#...........#.....#
#...###..#.#.##o##.#.#.###.#
#..#.....#...# ##....#.# #.#
#.#......#.##.#.##.#.#.###.#
#.#.####...................#
#.#....o#.###########..#...#
#..#####...............##..#
#........          ........#
####.#### ###  ### ####.####
 ........ #      # ........ 
####.#### ######## ####.####
#.......#          ........#
#.#.#...#..######..######..#
#.#.#.#.#..######......o#..#
#....................#####.#
#.######.####..#####....#..#
#.#    #.#.........#....#..#
#.######.#.#....##.#....#..#
#o.......#.........#.......#
############################
