#########################
#                       #
# ### #####   ##### ### #
# # # #           # # # #
# ### #  #######  # ### #
#     #           #     #
###   # ###   ### #   ###
        #       #        
###   # ######### #   ###
#     #           #     #
# ### #  #######  # ### #
# # # #           # # # #
# ### #####   ##### ### #
#                       #
#########################
