#########################
#......................o#
#.###.#####...#####.###.#
#.# #.#...........#.# #.#
#.###.#..#######..#.###.#
#.....#           #.....#
###...# ###   ### #...###
 ...... #       # ...... 
###...# ######### #...###
#.....#           #.....#
#.###.#..#######..#.###.#
#.# #.#...........#.# #.#
#.###.#####...#####.###.#
#o......................#
#########################
