#########################
#o..........#...........#
#.###.#..#######..#.###.#
#.#...#.....#.....#...#.#
#.#.###..#######..###.#.#
#.....#           #.....#
###.#.# ###   ### #.#.###
 ...#.. #       # ..#... 
###.#.# ######### #.#.###
#.....#           #.....#
#.#.###..#######..###.#.#
#.#...#.....#.....#...#.#
#.###.#..#######..#.###.#
#......................o#
#########################